##################
#P. ..#...... ..G#
#. ..#...##... ..#
#... ...####... .#
#.. ##...####... .#
#.. .. ...##... .#
#. ..#......... .#
##################